11111111000011111111
10000000000010000001
10000000000010000001
10000000000010000001
10000011111110000001
00000010000000000000
00000010000000000000
00000010000000000000
11111110000011111111
10000000000000000001
10000000000000000001
10000000000000000001
10000000000000000001
10000000000000000001
10001111111111100001
10000000000000000001
10000000000000000001
10000000000000000001
10000000000000000001
11111111000011111111
